11111111111111111111111111111
10P00000000000000001000000001
1C000000000000000000000000C01
10000000000E00000100001110C01
100010000000000000G00000C0001
10000000100010000001000000C01
10G0000000000000010G00000C001
100010000000000000G00000C0001
10000000100010000001000000C01
10G0000000000000010G00000C001
11111111111111111111111111111
