11111111111
1P0000000C1
10000000001
1000G0E0001
11111111111
