1111111
1P000C1
1000001
100XE01
1111111
