11111111
1PX000C1
10000001
1000X0E1
11111111
