1111111111111
1P000X0000001
1010101010101
1000000X000C1
10101010101C1
1000000000XE1
1111111111111
