111111111111
1P000X0X00C1
10X000000X01
100X00X000C1
10000X0X0001
1X0000000XE1
111111111111
