111111
1CCCC1
1CPCC1
1CCEC1
1CCCC1
111111
