111111111111
1P000000C001
101111111101
100000000101
101111110101
101000010101
101011010101
101010C10101
101011110101
101000000101
101111111101
1E00C0000001
111111111111
