1111111
1P10001
1110CE1
1000001
1111111
