1111111
1P00E01
1000001
1011101
101C101
1011101
1000001
1111111
