11111111
1P100CE1
10100001
10100001
10100001
10100001
11111111
