111111111
1P00C0001
100000001
111111111
100000001
1000E00C1
111111111
