111111111
1P0C01E01
100001001
100001001
100C01001
111111111
