1111111
1P010C1
1001001
1E01001
1111111
