1111111
1P00C01
1000001
1011101
101E101
1011101
1000001
1111111
