1111111
0P000C1
100E001
1111111
