1111111
1P000C1
100E000
1111111
