1111111
1P000C1
000E001
1111111
