1111111
1P000C0
100E001
1111111
