111111111111111
1P00X00X00X00C1
100000000000001
10000000000X0E1
111111111111111
