1111111111111
1P00000000001
1010101010101
1000000G000C1
10101010101C1
1000000000CE1
1111111111111
