11111111
1PG000C1
10000001
1000C0E1
11111111
