1111111
1P000C1
1000001
100GE01
1111111
