111111111111111
1P00C00C00C00C1
100000000000001
10000000000G0E1
111111111111111
