111111111111
1P000G0G00C1
10G000000G01
100G00G000C1
10000G0G0001
1G0000000GE1
111111111111
