111111111111111111111111111111
10P000000000000000010000000001
1C000000000000G00000000000C001
10000000000E00000100001110C001
100010000000000000G00000C00001
10000000100010000001000000C001
10C00000000000G0010C00000C0001
100010000000000000C00000C00001
10000000100010000001G00000C001
10C0000000000000010C00000C0001
111111111111111111111111111111
