111111111111111111
1000000EPC11111111
111111111111111111
