11111111111111111111111111111111111111111111111111
1P00C000C000C000C000C000C000C000C000C000C0000CE1
11111111111111111111111111111111111111111111111111
