111111111
1C0C0C0C1
100000001
1C0C0C0C1
100P00001
1C0C0C0E1
111111111
