1111111111
1P00000001
1011011101
10000C0001
1011011101
1000000001
1011011101
1000C000E1
1111111111
