111111111
1P00C00E1
100000001
100111001
100101001
1001C1001
100111001
100000001
111111111
