111111111
1P00000E1
100000001
101111101
10100C101
101111101
100000001
111111111
