1110111
1P000C1
100E001
1111111
