1111111
1P000P1
10C0001
1P00E01
1111111
