1111111
1P00PE1
10C0001
1000E01
1111111
