1111111111111111111111
1P000000000000000000C1
1011111111111111111101
1010000000000000000101
1010111111111111110101
1010100000000000010101
1010101111111110010101
1010100000000010010101
1010101111110010010101
1010100C000010010101C1
1010111111110010010101
1010000000000010010101
1010111111111110010101
10100000000000000101E1
1011111111111111110101
10000000000000000000G1
1111111111111111111111
