1111111111
1P0C00C0E1
1111111111
