111111111
1P0000001
1011111C1
1000000C1
1C11111C1
1000000E1
111111111
